Progress Quest
An Interactive Fiction by Josh Mermelstein
Release 1 / Serial number 140311 / Inform 7 build 6G60 (I6/v6.32 lib 6/12N) SD

Town
The town center is mysteriously abandoned.  The three shops, the Magic Shop to the west, The General Store to the south and The Smithy to the east are all but empty.  To the north, through the Town Gate are the killing fields, full of monsters to kill for experience

You see a pamphlet on the ground. The pamphlet looks worn and smells musky.

You can also see a Town Gate, a General Shop door, a Magic door, an Iron door and a Town key here.

>look at alex
Alex is a blacksmith.  He can sell you weapons and armor

* * *

Progress Quest
An Interactive Fiction by Josh Mermelstein
Release 1 / Serial number 140311 / Inform 7 build 6G60 (I6/v6.32 lib 6/12N) SD

Town
The town center is mysteriously abandoned.  The three shops, the Magic Shop to the west, The General Store to the south and The Smithy to the east are all but empty.  To the north, through the Town Gate are the killing fields, full of monsters to kill for experience

You see a pamphlet on the ground. The pamphlet looks worn and smells musky.

You can also see a Town Gate, a General Shop door, a Magic door, an Iron door and a Town key here.

>alex
That's not a verb I recognise.

>talk to alex
That's not a verb I recognise.

>look at alex
Alex is a blacksmith.  He can sell you weapons and armor

>look at bob
Bob is a mage.  He can help you with magical spells of all sorts

>look at carla
Carla manages the general store.  It is closed right now

>look at Darcy
Darcy is the town drunk.  She is rarely seen without a bottle of booze in hand

>look at ed
Ed is the town elder.  He may have a quest for you

* * *

Progress Quest
An Interactive Fiction by Josh Mermelstein
Release 1 / Serial number 140311 / Inform 7 build 6G60 (I6/v6.32 lib 6/12N) SD

Town
The town center is mysteriously abandoned.  The three shops, the Magic Shop to the west, The General Store to the south and The Smithy to the east are all but empty.  To the north, through the Town Gate are the killing fields, full of monsters to kill for experience

You see a pamphlet on the ground. The pamphlet looks worn and smells musky.

You can also see a Town Gate, a General Shop door, a Magic door, an Iron door and a Town key here.

>go in the fire door
(first opening the fire door)

The Smithey
You can see a fire door and Alex here.

>look at alex
Alex is a blacksmith.  He can sell you weapons and armor

* * *

Progress Quest
An Interactive Fiction by Josh Mermelstein
Release 1 / Serial number 140311 / Inform 7 build 6G60 (I6/v6.32 lib 6/12N) SD

Town
The town center is mysteriously abandoned.  The three shops, the Magic Shop to the west, The General Store to the south and The Smithy to the east are all but empty.  To the north, through the Town Gate are the killing fields, full of monsters to kill for experience

You see a pamphlet on the ground. The pamphlet looks worn and smells musky.

You can also see a Town Gate, a General Shop door, a Magic door, an Iron door and a Town key here.

>go in the magic door
(first opening the Magic door)

Magic Shop
You can see a Magic door and Bob here.

>go to town
You can't see any such thing.

>go west
You can't go that way.

>go east
Town
You awaken in town.

You can see a Magic door, a Smithy door, Carla, Darcy and Ed here.

>go in the smithy door
(first opening the Smithy door)

The Smithey
You can see a Smithy door and Alex here.

>look at alex
Alex is a blacksmith.  He can sell you weapons and armor

>go west
Town
You awaken in town.

You can see a Smithy door, a Magic door, Carla, Darcy and Ed here.

>go west
Magic Shop
You can see a Magic door and Bob here.

>talk to bob
That's not a verb I recognise.

>look at bob
Bob is a mage.  He can help you with magical spells of all sorts

* * *

Progress Quest
An Interactive Fiction by Josh Mermelstein
Release 1 / Serial number 140311 / Inform 7 build 6G60 (I6/v6.32 lib 6/12N) SD

Town
The town center is mysteriously abandoned.  The three shops, the Magic Shop to the west, The General Store to the south and The Smithy to the east are all but empty.  To the north, through the Town Gate are the killing fields, full of monsters to kill for experience

You see a pamphlet on the ground. The pamphlet looks worn and smells musky.

You can also see a Town Gate, a General Shop door, a Magic door, an Iron door and a Town key here.

>enter general shop door
(first opening the General shop door)

General Store
You can see a wooden ladder, a General shop door and Carla here.

>go down ladder
I only understood you as far as wanting to go down.

>climb ladder
I don't think much is to be achieved by that.

>go up ladder
I only understood you as far as wanting to go up.

>use ladder
That's not a verb I recognise.

* * *

Progress Quest
An Interactive Fiction by Josh Mermelstein
Release 1 / Serial number 140311 / Inform 7 build 6G60 (I6/v6.32 lib 6/12N) SD

Town
The town center is mysteriously abandoned.  The three shops, the Magic Shop to the west, The General Store to the south and The Smithy to the east are all but empty.  To the north, through the Town Gate are the killing fields, full of monsters to kill for experience

You see a pamphlet on the ground. The pamphlet looks worn and smells musky.

You can also see a Town Gate, a General Shop door, a Magic door, an Iron door and a Town key here.

>go south
(first opening the General shop door)

General Store
You can see a wooden ladder, a General shop door and Carla here.

>go south
Tavern
You can see a wooden ladder and Darcy here.

>look at darcy
Darcy is the town drunk.  She is rarely seen without a bottle of booze in hand

* * *

>go south
Tavern
You can see a wooden ladder and Darcy here.

>look at Darcy
Darcy is the town drunk.  She is rarely seen without a bottle of booze in hand

* * *

Progress Quest
An Interactive Fiction by Josh Mermelstein
Release 1 / Serial number 140311 / Inform 7 build 6G60 (I6/v6.32 lib 6/12N) SD

Town
The town center is mysteriously abandoned.  The three shops, the Magic Shop to the west, The General Store to the south and The Smithy to the east are all but empty.  To the north, through the Town Gate are the killing fields, full of monsters to kill for experience

You see a pamphlet on the ground. The pamphlet looks worn and smells musky.

You can also see a Town Gate, a General Shop door, a Magic door, an Iron door and a Town key here.

>look at the town gate
You see nothing special about the Town Gate.

>go in the town gate
Killng Fields 1
A way in.

>go in the town gate
Town
You are now in town.

A way out.

You can also see a General shop door, a Magic door and a Smithy door here.

>look
Town
You are now in town.

A way out.

You can also see a General shop door, a Magic door and a Smithy door here.

* * *

Progress Quest
An Interactive Fiction by Josh Mermelstein
Release 1 / Serial number 140311 / Inform 7 build 6G60 (I6/v6.32 lib 6/12N) SD

Town
The town center is mysteriously abandoned.  The three shops, the Magic Shop to the west, The General Store to the south and The Smithy to the east are all but empty.  To the north, through the Town Gate are the killing fields, full of monsters to kill for experience

You see a pamphlet on the ground. The pamphlet looks worn and smells musky.

You can also see a Town Gate, a General Shop door, a Magic door, an Iron door and a Town key here.

>go north
Killing Fields 1
You can see a Town Door and a Carion Crawler here.

>look
Killing Fields 1
You can see a Town Door and a Carion Crawler here.

>examine meg
You can't see any such thing.

* * *

>go north
Killing Fields 1
You can see a Town Door and a Carion Crawler here.

>attack joe
You attack Joe, causing 6 points of damage!

>restart
Progress Quest
An Interactive Fiction by Josh Mermelstein
Release 1 / Serial number 140310 / Inform 7 build 6G60 (I6/v6.32 lib 6/12N) SD

Town
You are now in town.

You can see a Town Door, a General shop door, a Magic door and a Smithy door here.

>go north
Killing Fields 1
You can see a Town Door and Joe here.

>hit joe
You attack Joe, causing 3 points of damage!

Joe expires, and is immediately carried away by the Arena slaves!

    *** The End ***

In that game you scored 0 out of a possible 0, in 2 turns.

Would you like to RESTART, RESTORE a saved game, QUIT or UNDO the last command?

* * *

>attack joe
You attack Joe, causing 6 points of damage!

>attack joe
You attack Joe, causing 2 points of damage!

>attack joe
You attack Joe, causing 6 points of damage!

>attack joe
You attack Joe, causing 9 points of damage!

>attack joe
You attack Joe, causing 6 points of damage!

>g
You attack Joe, causing 3 points of damage!

>g
You attack Joe, causing 6 points of damage!

Joe expires, and is immediately carried away by the Arena slaves!

    *** The End ***

In that game you scored 0 out of a possible 0, in 8 turns.

Would you like to RESTART, RESTORE a saved game, QUIT or UNDO the last command?

* * *

>go north
Killing Fields 1
You can see a Town Door and a Carion Crawler here.

>hit joe
You attack Joe, causing 4 points of damage!

>hit joe
You attack Joe

>g
You attack Joe

>g
You attack Joe

* * *

>hit joe
You attack Joe, causing 4 points of damage!

>g
You attack Joe, causing 4 points of damage!

>g
You attack Joe, causing 4 points of damage!

>g
You attack Joe, causing 3 points of damage!

Joe expires, and is immediately carried away by the Arena slaves!

[Your score has just gone up by five points.]

>g
You attack Joe, causing 3 points of damage!

Joe expires, and is immediately carried away by the Arena slaves!

>look
Killing Fields 1
You can see a Town Door and Jake here.

>hit james
You can't see any such thing.

>hit jake
You attack Jake, causing 4 points of damage!

>g
You attack Jake, causing 5 points of damage!

>g
You attack Jake, causing 3 points of damage!

Jake expires, and is immediately carried away by the Arena slaves!

>g
You can't see any such thing.

>look
Killing Fields 1
You can see a Town Door here.

* * *

>g
You attack Joe, causing 3 points of damage!

Joe expires, and is immediately carried away by the Arena slaves!

[Your score has just gone up by five points.]

>hit jake
You attack Jake, causing 4 points of damage!

>g
You attack Jake, causing 3 points of damage!

>g
You attack Jake, causing 4 points of damage!

Jake expires, and is immediately carried away by the Arena slaves!

[Your score has just gone up by five points.]

>score
You have so far scored 10 out of a possible 0, in 9 turns.

* * *

>hit joe
You attack Joe, causing 4 points of damage!

>.
That's not a verb I recognise.

>hit joe
You attack Joe, causing 2 points of damage!

>g
You attack Joe, causing 2 points of damage!

>g
You attack Joe, causing 5 points of damage!

Joe  is slain!

[Your score has just gone up by five points.]

>inventory
You are carrying nothing.

* * *

>go north
Killing Fields 1
You can see a Town Door and a Carion Crawler here.

>hit the carion crawler
You attack the Carion Crawler, causing 5 points of damage!

>g
You attack the Carion Crawler, causing 2 points of damage!

>g
You attack the Carion Crawler, causing 5 points of damage!

The Carion Crawler  is slain!

[Your score has just gone up by five points.]

>g
You attack the Carion Crawler, causing 5 points of damage!

The Carion Crawler  is slain!

[Your score has just gone up by five points.]

>go north
Killing Fields 2
You can see a Fire worm and an Ice worm here.

>hit the fire worm
You attack the Fire worm, causing 4 points of damage!

>.
That's not a verb I recognise.

* * *

Progress Quest
An Interactive Fiction by Josh Mermelstein
Release 1 / Serial number 140311 / Inform 7 build 6G60 (I6/v6.32 lib 6/12N) SD

Town
The town center is mysteriously abandoned.  The three shops, the Magic Shop to the west, The General Store to the south and The Smithy to the east are all but empty.  To the north, through the Town Gate are the killing fields, full of monsters to kill for experience

You see a pamphlet on the ground. The pamphlet looks worn and smells musky.

You can also see a Town Gate, a General Shop door, a Magic door, an Iron door and a Town key here.

>go east
(first opening the Iron door)

The Smithy
You can see an Iron door and a magic key here.

>look
The Smithey
You can see a Smithy door here.

* * *

>go east
(first opening the Iron door)

The Smithy
You can see an Iron door and a magic key here.

>take the key
Taken.

>go west
Town
You are now in town.

You can see an Iron door, a Town Door, a General shop door and a Magic door here.

>unlock the magic door with the magic key
You unlock the Magic door.

>open the magic door
You open the Magic door.

>go in the magic door
Magic Shop
You can see a Magic door here.

* * *

Progress Quest
An Interactive Fiction by Josh Mermelstein
Release 1 / Serial number 140311 / Inform 7 build 6G60 (I6/v6.32 lib 6/12N) SD

Town
The town center is mysteriously abandoned.  The three shops, the Magic Shop to the west, The General Store to the south and The Smithy to the east are all but empty.  To the north, through the Town Gate are the killing fields, full of monsters to kill for experience

You see a pamphlet on the ground. The pamphlet looks worn and smells musky.

You can also see a Town Gate, a General Shop door, a Magic door, an Iron door and a Town key here.

>go in the iron door
(first opening the iron door)

The Smithy
You can see an iron door and a rusty key here.

>take the key
Taken.

>i
You are carrying:
  a rusty key

* * *

Progress Quest
An Interactive Fiction by Josh Mermelstein
Release 1 / Serial number 140311 / Inform 7 build 6G60 (I6/v6.32 lib 6/12N) SD

Town
The town center is mysteriously abandoned.  The three shops, the Magic Shop to the west, The General Store to the south and The Smithy to the east are all but empty.  To the north, through the Town Gate are the killing fields, full of monsters to kill for experience

You see a pamphlet on the ground. The pamphlet looks worn and smells musky.

You can also see a Town Gate, a General Shop door, a Magic door, an Iron door and a Town key here.

>open iron door
You open the Iron door.

>go in iron door
The Smithy
You can see an Iron door and a magic key here.

>take key
Taken.

>go in iron door
Town
You are now in town.

You can see an Iron door, a Town Door, a General shop door and a Magic door here.

>unlock magic door with magic key
You unlock the Magic door.

>open magic door
You open the Magic door.

>go in magic door
Magic Shop
You can see a Magic door here.

>open general shop door
You can't see any such thing.

>open General shop door
You can't see any such thing.

>open town door
You can't see any such thing.

>go in town door
You can't see any such thing.

>go south
You can't go that way.

>go north
You can't go that way.

>go east
Town
You are now in town.

You can see a Magic door, an Iron door, a Town Door and a General shop door here.

>clear
(the magic key)
Nothing obvious happens.

>i
You are carrying:
  a magic key

>open town door
It seems to be locked.

>open general shop door
It seems to be locked.

* * *

Progress Quest
An Interactive Fiction by Josh Mermelstein
Release 1 / Serial number 140311 / Inform 7 build 6G60 (I6/v6.32 lib 6/12N) SD

Town
The town center is mysteriously abandoned.  The three shops, the Magic Shop to the west, The General Store to the south and The Smithy to the east are all but empty.  To the north, through the Town Gate are the killing fields, full of monsters to kill for experience

You see a pamphlet on the ground. The pamphlet looks worn and smells musky.

You can also see a Town Gate, a General Shop door, a Magic door, an Iron door and a Town key here.

>go in iron door
(first opening the Iron door)

The Smithy
This smithy smells faintly of burnt fuel and metal.  Sadly there are no useful tools left for you to "borrow"

You can see an Iron door and a magic key here.

>get key
Taken.

>go in iron door
Town
The town center is mysteriously abandoned.  The three shops, the Magic Shop to the west, The General Store to the south and The Smithy to the east are all but empty.  To the north, through the Town Gate are the killing fields, full of monsters to kill for experience

You can see an Iron door, a Town Gate, a General Shop door and a Magic door here.

>go in magic door
(first opening the Magic door)
It seems to be locked.

>unlock magic door with magic key
You unlock the Magic door.

>go in magic door
(first opening the Magic door)

Magic Shop
You can see a Magic door and a store key here.

>take key
(the store key)
Taken.

>go out magic door
I only understood you as far as wanting to go outside.

>go in magic door
Town
You are now in town.

You can see a Magic door, an Iron door, a Town Door and a General shop door here.

>unlock store
What do you want to unlock the store key with?

>c
You can't see any such thing.

>look
Town
You are now in town.

You can see a Magic door, an Iron door, a Town Door and a General shop door here.

>unlock shop door with store key
You unlock the General shop door.

>go in shop door
(first opening the General shop door)

General Store
You can see a General shop door and a Town key here.

>take town key
Taken.

>go in shop door
Town
You are now in town.

You can see a General shop door, a Magic door, an Iron door and a Town Door here.

>unlock town door with town key
You unlock the Town Door.

>go in town door
(first opening the Town Door)

Killing Fields 1
You can see a Town Door and a Carion Crawler here.

>attack carion crawler
You attack the Carion Crawler, causing 4 points of damage!

>g
You attack the Carion Crawler, causing 4 points of damage!

>g
You attack the Carion Crawler, causing 3 points of damage!

The Carion Crawler  is slain!

[Your score has just gone up by five points.]

* * *

>go in iron door
Town
The town center is mysteriously abandoned.  The three shops, the Magic Shop to the west, The General Store to the south and The Smithy to the east are all but empty.  To the north, through the Town Gate are the killing fields, full of monsters to kill for experience

You can see an Iron door, a Town Gate, a General Shop door and a Magic door here.

>unlock magic door with key
You unlock the Magic door.

>go in magic door
(first opening the Magic door)

Magic Shop
Adventurers use to stop here to buy potions and spells.  Unfortunately for them this was the kind of magic shop that sold cheap gags and the like.

You can see a Magic door, a Store key and a can of nuts here.

>take key
(the Store key)
Taken.

>go in magic door
Town
The town center is mysteriously abandoned.  The three shops, the Magic Shop to the west, The General Store to the south and The Smithy to the east are all but empty.  To the north, through the Town Gate are the killing fields, full of monsters to kill for experience

You can see a Magic door, an Iron door, a Town Gate and a General Shop door here.

>unlock shop door with store key
You unlock the General Shop door.

>go in shop door
(first opening the General Shop door)

General Store
A place to buy and sell things.  Too bad there is no one here to trade with.

You can see a General Shop door, a Town key and a sword here.

>take key
(the Town key)
Taken.

>take sword
Taken.

>go in shop door
Town
The town center is mysteriously abandoned.  The three shops, the Magic Shop to the west, The General Store to the south and The Smithy to the east are all but empty.  To the north, through the Town Gate are the killing fields, full of monsters to kill for experience

You can see a General Shop door, a Magic door, an Iron door and a Town Gate here.

>open gate with town key
You unlock the Town Gate.

>go north
(first opening the Town Gate)

Killing Fields 1
The first of seven killing fields

You can see a Town Gate and a Disembodied Hand here.

>g
Killing Fields 2
The second of seven killing fields

You can see a Fire worm and an Ice worm here.

>g
Killing Fields 3
The third of seven killing fields

You can see a shadow knight, a shadow horse and a shadow sword here.

>g
Killing Fields 4
The fourth of seven killing fields

You can see a cyan imp, a yellow imp, a magenta imp and a black imp here.

>g
Killing Fields 5
The fifth of seven killing fields

You can see a choreographer, a ballerina, a break dancer, a gymnast and a supermodel here.

>g
Killing Fields 6
The sixth of seven killing fields

You can see a kitchen ghost, a cursed immersion blender, a cursed cheese grater, a cursed popcorn popper, a cursed salad spinner and a cursed pizza cutter here.

>g
Killing Fields 7
The last of seven killing fields

You can see an evil king here.

>g
You can't go that way.

>hit king
You attack the evil king, causing 15 points of damage!

>g
You attack the evil king, causing 16 points of damage!

>g
You attack the evil king, causing 15 points of damage!

>g
You attack the evil king, causing 17 points of damage!

>g
You attack the evil king, causing 18 points of damage!

>g
You attack the evil king, causing 17 points of damage!

>g
You attack the evil king, causing 15 points of damage!

The evil king  is slain!

[Your score has just gone up by five points.]

* * *

>go in iron door
(first opening the Iron door)

The Smithy
This smithy smells faintly of burnt fuel and metal.  Sadly there are no useful tools left for you to "borrow"

You can see an Iron door and a magic key here.

>take key
Taken.

>examine key
I bet this key unlocks a magic door!

>go door
Town
The town center is mysteriously abandoned.  The three shops, the Magic Shop to the west, The General Store to the south and The Smithy to the east are all but empty.  To the north, through the Town Gate are the killing fields, full of monsters to kill for experience

You can see an Iron door, a Town Gate, a General Shop door and a Magic door here.

>unlock magic door with magic key
You unlock the Magic door.

>go magic door
(first opening the Magic door)

Magic Shop
Adventurers use to stop here to buy potions and spells.  Unfortunately for them this was the kind of magic shop that sold cheap gags and the like.

You can see a Magic door, a Store key and a can of nuts here.

>take key
(the Store key)
Taken.

>examine it
I bet this unlocks a store!

>tkae can
That's not a verb I recognise.

>take nuts
Taken.

>examine it
Full of snakes.

* * *

Progress Quest
An Interactive Fiction by Josh Mermelstein
Release 1 / Serial number 140311 / Inform 7 build 6G60 (I6/v6.32 lib 6/12N) SD

Town
The town center is mysteriously abandoned.  The three shops, the Magic Shop to the west, The General Store to the south and The Smithy to the east are all but empty.  To the north, through the Town Gate are the killing fields, full of monsters to kill for experience

You see a pamphlet on the ground. The pamphlet looks worn and smells musky.

You can also see a Town Gate, a General Shop door, a Magic door, an Iron door and a Town key here.

>take the sword
Taken.

>go in iron door
(first opening the Iron door)

The Smithy
You can see an Iron door and a magic key here.

>take key
Taken.

>go in iron door
Town
The town center is mysteriously abandoned.  The three two shops, the Magic Shop to the west, The General Store to the south and The Smithy to the east are all but empty.  To the north, through the Town Gate are the killing fields, full of monsters to kill for experience

You can see an Iron door, a Town Door, a General shop door and a Magic door here.

>unlock magic door with key
You unlock the Magic door.

>go in magic door
(first opening the Magic door)

Magic Shop
You can see a Magic door and a store key here.

* * *

>take key
(the store key)
Taken.

>go in magic door
Town
The town center is mysteriously abandoned.  The three two shops, the Magic Shop to the west, The General Store to the south and The Smithy to the east are all but empty.  To the north, through the Town Gate are the killing fields, full of monsters to kill for experience

You can see a Magic door, an Iron door, a Town Door and a General shop door here.

>unlock shop door with store key
You unlock the General shop door.

* * *

>take town key
Taken.

>go in shop door
Town
The town center is mysteriously abandoned.  The three two shops, the Magic Shop to the west, The General Store to the south and The Smithy to the east are all but empty.  To the north, through the Town Gate are the killing fields, full of monsters to kill for experience

You can see a General shop door, a Magic door, an Iron door and a Town Door here.

>unlock town door with town key
You unlock the Town Door.

>go n
(first opening the Town Door)

Killing Fields 1
You can see a Town Door and a Carion Crawler here.

>attack crawler
You attack the Carion Crawler, causing 3 points of damage!

>g
You attack the Carion Crawler, causing 5 points of damage!

>g
You attack the Carion Crawler, causing 5 points of damage!

The Carion Crawler  is slain!

[Your score has just gone up by five points.]

* * *

>go north
Killing Fields 2
You can see a Fire worm and an Ice worm here.

>attack fire worm
You attack the Fire worm, causing 5 points of damage!

>g
You attack the Fire worm, causing 4 points of damage!

>g
You attack the Fire worm, causing 3 points of damage!

The Fire worm  is slain!

[Your score has just gone up by five points.]

>g
You can't see any such thing.

>attack ice worm
You attack the Ice worm, causing 4 points of damage!

>g
You attack the Ice worm, causing 5 points of damage!

>g
You attack the Ice worm, causing 3 points of damage!

The Ice worm  is slain!

[Your score has just gone up by five points.]

>go north
Killing Fields 3
You can see a shadow knight, a shadow horse and a shadow sword here.

>hit knight
You attack the shadow knight, causing 3 points of damage!

>g
You attack the shadow knight, causing 5 points of damage!

>g
You attack the shadow knight, causing 6 points of damage!

The shadow knight  is slain!

[Your score has just gone up by five points.]

* * *

Progress Quest
An Interactive Fiction by Josh Mermelstein
Release 1 / Serial number 140311 / Inform 7 build 6G60 (I6/v6.32 lib 6/12N) SD

Town
The town center is mysteriously abandoned.  The three shops, the Magic Shop to the west, The General Store to the south and The Smithy to the east are all but empty.  To the north, through the Town Gate are the killing fields, full of monsters to kill for experience

You see a pamphlet on the ground. The pamphlet looks worn and smells musky.

You can also see a Town Gate, a General Shop door, a Magic door, an Iron door and a Town key here.

>go iron door
(first opening the Iron door)

The Smithy
You can see an Iron door and a magic key here.

>take key
Taken.

>go iron door
Town
The town center is mysteriously abandoned.  The three two shops, the Magic Shop to the west, The General Store to the south and The Smithy to the east are all but empty.  To the north, through the Town Gate are the killing fields, full of monsters to kill for experience

You can see an Iron door, a Town Gate, a General Shop door and a Magic door here.

>unlock magic door with key
You unlock the Magic door.

>go magic
(the magic key)
That's not something you can enter.

>go magic door
(first opening the Magic door)

Magic Shop
You can see a Magic door and a store key here.

>take key
(the store key)
Taken.

>go magic door
Town
The town center is mysteriously abandoned.  The three two shops, the Magic Shop to the west, The General Store to the south and The Smithy to the east are all but empty.  To the north, through the Town Gate are the killing fields, full of monsters to kill for experience

You can see a Magic door, an Iron door, a Town Gate and a General Shop door here.

>use shop key on general store door
That's not a verb I recognise.

>unlock general sotre
I didn't understand that sentence.

>unlock general store door
I didn't understand that sentence.

>unlock general store door with shop key
I didn't understand that sentence.

>unlock shop door with store key
You unlock the General Shop door.

>go in shop door
(first opening the General Shop door)

General Store
You can see a General Shop door, a Town key and a sword here.

>take key
(the Town key)
Taken.

* * *

>take sword
Taken.

>go shop door
Town
The town center is mysteriously abandoned.  The three two shops, the Magic Shop to the west, The General Store to the south and The Smithy to the east are all but empty.  To the north, through the Town Gate are the killing fields, full of monsters to kill for experience

You can see a General Shop door, a Magic door, an Iron door and a Town Gate here.

>unlock gate with town key
You unlock the Town Gate.

>go north
(first opening the Town Gate)

Killing Fields 1
You can see a Town Gate and a Carion Crawler here.

>hit crawler
You attack the Carion Crawler, causing 7 points of damage!

>g
You attack the Carion Crawler, causing 7 points of damage!

The Carion Crawler  is slain!

[Your score has just gone up by five points.]

>g
You can't see any such thing.

>go north
Killing Fields 2
You can see a Fire worm and an Ice worm here.

>hit fire
You attack the Fire worm, causing 8 points of damage!

>g
You attack the Fire worm, causing 8 points of damage!

The Fire worm  is slain!

[Your score has just gone up by five points.]

>g
You can't see any such thing.

>hit ice
You attack the Ice worm, causing 5 points of damage!

>g
You attack the Ice worm, causing 7 points of damage!

The Ice worm  is slain!

[Your score has just gone up by five points.]

I beg your pardon?

* * *

Progress Quest
An Interactive Fiction by Josh Mermelstein
Release 1 / Serial number 140311 / Inform 7 build 6G60 (I6/v6.32 lib 6/12N) SD

Town
The town center is mysteriously abandoned.  The three shops, the Magic Shop to the west, The General Store to the south and The Smithy to the east are all but empty.  To the north, through the Town Gate are the killing fields, full of monsters to kill for experience

You see a pamphlet on the ground. The pamphlet looks worn and smells musky.

You can also see a Town Gate, a General Shop door, a Magic door, an Iron door and a Town key here.

>go in smithy
You can't see any such thing.

>go iron door
(first opening the Iron door)

The Smithy
This smithy smells faintly of burnt fuel and metal.  Sadly there are no useful tools left for you to "borrow"

You can see an Iron door and a magic key here.

* * *

Progress Quest
An Interactive Fiction by Josh Mermelstein
Release 1 / Serial number 140311 / Inform 7 build 6G60 (I6/v6.32 lib 6/12N) SD

Town
The town center is mysteriously abandoned.  The three shops, the Magic Shop to the west, The General Store to the south and The Smithy to the east are all but empty.  To the north, through the Town Gate are the killing fields, full of monsters to kill for experience

You see a pamphlet on the ground. The pamphlet looks worn and smells musky.

You can also see a Town Gate, a General Shop door, a Magic door, an Iron door and a Town key here.

>take key
Taken.

>unlock gate with key
You unlock the Town Gate.

>go n
(first opening the Town Gate)

Killing Fields 1
The first of seven killing fields

You can see a Town Gate and a Disembodied Hand here.

>g
Killing Fields 2
The second of seven killing fields

You can see a Fire worm and an Ice worm here.

* * *

>g
Killing Fields 7
The last of seven killing fields

You can see an evil king here.

>hit evil king
You attack the evil king, causing 0 points of damage!

* * *

>take key
Taken.

>go in iron door
(first opening the Iron door)

The Smithy
This smithy smells faintly of burnt fuel and metal.  Sadly there are no useful tools left for you to "borrow"

You can see an Iron door and a magic key here.

>take key
(the magic key)
Taken.

>go in iron door
Town
The town center is mysteriously abandoned.  The three shops, the Magic Shop to the west, The General Store to the south and The Smithy to the east are all but empty.  To the north, through the Town Gate are the killing fields, full of monsters to kill for experience

You can see an Iron door, a Town Gate, a General Shop door and a Magic door here.

>unlock magic door with magic key
You unlock the Magic door.

>go in magic door
(first opening the Magic door)

Magic Shop
Adventurers use to stop here to buy potions and spells.  Unfortunately for them this was the kind of magic shop that sold cheap gags and the like.

You can see a Magic door, a Store key and a can of nuts here.

* * *

>unlock shop door with store key
You unlock the General Shop door.

>go in shop door
(first opening the General Shop door)

General Store
A place to buy and sell things.  Too bad there is no one here to trade with.

You can see a General Shop door and a sword here.

>take sword
Taken.

* * *

>go in shop door
Town
The town center is mysteriously abandoned.  The three shops, the Magic Shop to the west, The General Store to the south and The Smithy to the east are all but empty.  To the north, through the Town Gate are the killing fields, full of monsters to kill for experience

You can see a General Shop door, a Magic door, an Iron door and a Town Gate here.

>unlock gate with town key
You unlock the Town Gate.

>go north
(first opening the Town Gate)

Killing Fields 1
The first of seven killing fields

You can see a Town Gate and a Disembodied Hand here.

>hit hand
You attack the Disembodied Hand, causing 7 points of damage!

>g
You attack the Disembodied Hand, causing 6 points of damage!

The Disembodied Hand  is slain!

[Your score has just gone up by five points.]

>go north
Killing Fields 2
The second of seven killing fields

You can see a Fire worm and an Ice worm here.

>hit worm
Who do you mean, the Fire worm or the Ice worm?

>fire
You attack the Fire worm, causing 8 points of damage!

>g
You attack the Fire worm, causing 5 points of damage!

The Fire worm  is slain!

[Your score has just gone up by five points.]

>hit worm
You attack the Ice worm, causing 7 points of damage!

>g
You attack the Ice worm, causing 6 points of damage!

The Ice worm  is slain!

[Your score has just gone up by five points.]

>g
You can't see any such thing.

>go north
Killing Fields 3
The third of seven killing fields

You can see a shadow knight, a shadow horse and a shadow sword here.

>hit knight
You attack the shadow knight, causing 7 points of damage!

>g
You attack the shadow knight, causing 7 points of damage!

The shadow knight  is slain!

[Your score has just gone up by five points.]

>hit horse
You attack the shadow horse, causing 7 points of damage!

>g
You attack the shadow horse, causing 5 points of damage!

The shadow horse  is slain!

[Your score has just gone up by five points.]

>hit sord
You can't see any such thing.

>hit sword
(the sword)
Violence isn't the answer to this one.

>look
Killing Fields 3
The third of seven killing fields

You can see a shadow sword here.

>hit sword
(the sword)
Violence isn't the answer to this one.

>fight sword
(the sword)
Violence isn't the answer to this one.

>fight shadow sword
You attack the shadow sword, causing 8 points of damage!

>g
You attack the shadow sword, causing 7 points of damage!

The shadow sword  is slain!

[Your score has just gone up by five points.]

>look
Killing Fields 3
The third of seven killing fields

>go north
Killing Fields 4
The fourth of seven killing fields

You can see a cyan imp, a yellow imp, a magenta imp and a black imp here.

>hit imp
Who do you mean, the cyan imp, the yellow imp, the magenta imp or the black imp?

>cyan
You attack the cyan imp, causing 7 points of damage!

>g
You attack the cyan imp, causing 7 points of damage!

The cyan imp  is slain!

[Your score has just gone up by five points.]

>hit img
You can't see any such thing.

>hit imp
Who do you mean, the yellow imp, the magenta imp or the black imp?

>yellow
You attack the yellow imp, causing 6 points of damage!

>g
You attack the yellow imp, causing 8 points of damage!

The yellow imp  is slain!

[Your score has just gone up by five points.]

>g
You can't see any such thing.

>hit imp
Who do you mean, the magenta imp or the black imp?

>magenta
You attack the magenta imp, causing 6 points of damage!

>g
You attack the magenta imp, causing 6 points of damage!

The magenta imp  is slain!

[Your score has just gone up by five points.]

>hit imp
You attack the black imp, causing 7 points of damage!

>g
You attack the black imp, causing 6 points of damage!

The black imp  is slain!

[Your score has just gone up by five points.]

>go north
Killing Fields 5
The fifth of seven killing fields

You can see a choreographer, a ballerina, a break dancer, a gymnast and a supermodel here.

>hit chor
You can't see any such thing.

>hit choreographer
You attack the choreographer, causing 6 points of damage!

>g
You attack the choreographer, causing 8 points of damage!

The choreographer  is slain!

[Your score has just gone up by five points.]

>hit ballerina
You attack the ballerina, causing 7 points of damage!

>g
You attack the ballerina, causing 5 points of damage!

The ballerina  is slain!

[Your score has just gone up by five points.]

>hit dancer
You attack the break dancer, causing 6 points of damage!

>g
You attack the break dancer, causing 7 points of damage!

The break dancer  is slain!

[Your score has just gone up by five points.]

>hit gymnast
You attack the gymnast, causing 8 points of damage!

>g
You attack the gymnast, causing 7 points of damage!

The gymnast  is slain!

[Your score has just gone up by five points.]

>hit supermodel
You attack the supermodel, causing 7 points of damage!

>g
You attack the supermodel, causing 8 points of damage!

The supermodel  is slain!

[Your score has just gone up by five points.]

>look
Killing Fields 5
The fifth of seven killing fields

>go north
Killing Fields 6
The sixth of seven killing fields

You can see a kitchen ghost, a cursed immersion blender, a cursed cheese grater, a cursed popcorn popper, a cursed salad spinner and a cursed pizza cutter here.

>hit ghost
You attack the kitchen ghost, causing 5 points of damage!

>g
You attack the kitchen ghost, causing 5 points of damage!

The kitchen ghost  is slain!

[Your score has just gone up by five points.]

>hit blender
You attack the cursed immersion blender, causing 7 points of damage!

>g
You attack the cursed immersion blender, causing 5 points of damage!

The cursed immersion blender  is slain!

[Your score has just gone up by five points.]

>hit grater
You attack the cursed cheese grater, causing 8 points of damage!

>g
You attack the cursed cheese grater, causing 5 points of damage!

The cursed cheese grater  is slain!

[Your score has just gone up by five points.]

>hit popper
You attack the cursed popcorn popper, causing 7 points of damage!

>g
You attack the cursed popcorn popper, causing 7 points of damage!

The cursed popcorn popper  is slain!

[Your score has just gone up by five points.]

>look
Killing Fields 6
The sixth of seven killing fields

You can see a cursed salad spinner and a cursed pizza cutter here.

>hit salad
You attack the cursed salad spinner, causing 6 points of damage!

>g
You attack the cursed salad spinner, causing 8 points of damage!

The cursed salad spinner  is slain!

[Your score has just gone up by five points.]

>hit pizza
You attack the cursed pizza cutter, causing 7 points of damage!

>g
You attack the cursed pizza cutter, causing 7 points of damage!

The cursed pizza cutter  is slain!

[Your score has just gone up by five points.]

>look
Killing Fields 6
The sixth of seven killing fields

>go north
Killing Fields 7
The last of seven killing fields

You can see an evil king here.

>hit king
You attack the evil king, causing 5 points of damage!

>g
You attack the evil king, causing 6 points of damage!

>g
You attack the evil king, causing 7 points of damage!

>g
You attack the evil king, causing 7 points of damage!

>g
You attack the evil king, causing 6 points of damage!

>g
You attack the evil king, causing 6 points of damage!

>g
You attack the evil king, causing 8 points of damage!

I beg your pardon?

I beg your pardon?

>hit king
You attack the evil king, causing 8 points of damage!

>g
You attack the evil king, causing 8 points of damage!

>g
You attack the evil king, causing 7 points of damage!

>g
You attack the evil king, causing 8 points of damage!

* * *

>g
You attack the evil king, causing 7 points of damage!

>g
You attack the evil king, causing 6 points of damage!

The evil king  is slain!

    *** You have won ***

In that game you scored 110 out of a possible 105, in 85 turns.

Would you like to RESTART, RESTORE a saved game, QUIT or UNDO the last command?

>g
Please give one of the answers above.

Would you like to RESTART, RESTORE a saved game, QUIT or UNDO the last command?

* * *

>take key
Taken.

>unlock gate
(with the Town key)
You unlock the Town Gate.

>go north
(first opening the Town Gate)

Killing Fields 1
The first of seven killing fields

You can see a Town Gate and a Disembodied Hand here.

* * *

>g
Killing Fields 3
The third of seven killing fields

You can see a shadow knight, a shadow horse and a shadow sword here.

I beg your pardon?

>g
Killing Fields 4
The fourth of seven killing fields

You can see a cyan imp, a yellow imp, a magenta imp and a black imp here.

* * *

>g
Killing Fields 7
The last of seven killing fields

You can see an evil king here.

>hit king
The king cannot be hurt until his minions have been slain.
You attack the evil king, causing 0 points of damage!

* * *

Progress Quest
An Interactive Fiction by Josh Mermelstein
Release 1 / Serial number 140311 / Inform 7 build 6G60 (I6/v6.32 lib 6/12N) SD

Town
The town center is mysteriously abandoned.  The three shops, the Magic Shop to the west, The General Store to the south and The Smithy to the east are all but empty.  To the north, through the Town Gate are the killing fields, full of monsters to kill for experience

You see a pamphlet on the ground. The pamphlet looks worn and smells musky.

You can also see a Town Gate, a General Shop door, a Magic door, an Iron door and a Town key here.

>take the pamphlet
Taken.

>read the pamphlet
Welcome to progress quest.  To win the game you must kill the evil king.  He can be found in the final killing fields, far North of town.

>go north
(first opening the Town Gate)
It seems to be locked.